7
7
#######
#..x.x#
##.####
#..x..#
#####.#
#P...x#
#######